STRING	STRING	STRING
标题	文字	描述
boss_title	t_server_language_text_boss_title	魔王讨伐战累计伤害排名奖励
boss_text	t_server_language_text_boss_text	    您在这次魔王讨伐战中累计伤害排名第%d，这是您的排名奖励。
boss_top_title	t_server_language_text_boss_top_title	魔王讨伐战最高伤害排名奖励
boss_top_text	t_server_language_text_boss_top_text	    您在这次魔王讨伐战中最高伤害排名第%d，这是您的排名奖励。
zsname	t_server_language_text_zsname	艾丽斯
sys_sender	t_server_language_text_sys_sender	斗人少尉
levelup	t_server_language_text_levelup	恭喜[00ff00]%s[-]升到了[ff00ff]%d[-]级
lianjin	t_server_language_text_lianjin	恭喜[00ff00]%s[-]在炼金中出现了[ff00ff]10倍[-]暴击
shouchong	t_server_language_text_shouchong	恭喜[00ff00]%s[-]领取了价值[ff00ff]6999钻石[-]的首充大礼包
chouka	t_server_language_text_chouka	恭喜[00ff00]%s[-]招募到了%s，可喜可贺！
hbb	t_server_language_text_hbb	恭喜[00ff00]%s[-]在援救伙伴中获得了%s
mission	t_server_language_text_mission	恭喜[00ff00]%s[-]通关了[ff00ff]%s
sport_first	t_server_language_text_sport_first	玩家[00ff00]%s[-]在竞技场里痛揍了[00ff00]%s[-]获得了[ff00ff]第一名[-]的宝座
juntuan_gonggao	t_server_language_text_juntuan_gonggao	这个军团长很懒，什么都没有写~~~~
level_rank_login	t_server_language_text_level_rank_login	全服[ff00ff]等级第一[-]的[00ff00]%s[-]上线了，大家热烈欢迎
bf_rank_login	t_server_language_text_bf_rank_login	全服[ff00ff]战力第一[-]的[00ff00]%s[-]上线了，大家热烈欢迎
first_rank_login	t_server_language_text_first_rank_login	全服[ff00ff]排名第一[-]的[00ff00]%s[-]上线了，大家热烈欢迎
boss_open	t_server_language_text_boss_open	[00ff00]斗人少尉[-]：BOSS战已经开启，请各[ff00ff]猎人[-]速速前去迎战
guild_boss_open	t_server_language_text_guild_boss_open	[00ff00]明日少尉[-]：军团探险已开启，请各[ff00ff]军团[-]立即前往探险
yb_ts	t_server_language_text_yb_ts	[00ff00]%s[-]运气极佳，开始运输%s货船
guild_create_danmu	t_server_language_guild_create_danmu	玩家[ffff00]%s[-]创建了军团[ffff00]%s[-]！
guild_leave_title	t_server_language_guild_leave_title	您被移出军团
guild_leave_text	t_server_language_guild_leave_text	您被移出了【%s】军团，可以尝试加入新军团。
guild_jiesan_title	t_server_language_guild_jiesan_title	军团解散信息
guild_jiesan_text	t_server_language_guild_jiesan_text	您所在的【%s】军团已被解散，可以尝试加入新军团
change_name_social_title	t_server_language_change_name_social_title	好友改名通知
change_name_social_text	t_server_language_change_name_social_text	您的好友【%s】已经改名为【%s】，请知悉
change_name_guild_title	t_server_language_change_name_guild_title	军团成员改名通知
change_name_guild_text	t_server_language_change_name_guild_text	军团成员【%s】已经改名为【%s】，请大家知悉
pvp_rank_title	t_server_language_pvp_rank_title	猎人大会排名奖励
pvp_rank_text	t_server_language_pvp_rank_text	恭喜您猎人大会排名【%d】，这是您的奖励
tanbao_normal_reward_title	t_server_language_tanbao_nrtitle	探宝排名奖励
tanbao_normal_reward_text	t_server_language_tanbao_nrtext	恭喜您排名第%d名，这是您的奖励
tanbao_jy_reward_title	t_server_language_tanbao_jrtitle	探宝精英排名奖励
tanbao_jy_reward_text	t_server_language_tanbao_jrtext	恭喜您排名第%d名，这是您的奖励
bingyuan_rank_title	t_server_language_bingyuan_title	冰原战斗排名奖励
bingyuan_rank_text	t_server_language_bingyuan_text	恭喜您排名第%d名，这是您的奖励
zhuanpan_normal_reward_title	t_server_language_zhuanpan_normal_title	转盘排名奖励
zhuanpan_normal_reward_text	t_server_language_zhuanpan_normal_text	恭喜您排名第%d名，这是您的奖励
zhuanpan_jy_reward_title	t_server_language_zhuanpan_jy_title	转盘精英排名奖励
zhuanpan_jy_reward_text	t_server_language_zhuanpan_jy_text	恭喜您排名第%d名，这是您的奖励
social_invite_title	t_server_language_social_invite_title	好友邀请成功
social_invite_text	t_server_language_social_invite_text	您的好友[ffff00]%s[-]接受了您的邀请进入了游戏，感谢您的鼎力宣传，请帮助好友一起共同成长，可以在好友邀请中获得丰厚奖励哦
tansuo_normal_reward_title	t_server_language_tansuo_normal_title	太空漫游排名奖励
tansuo_normal_reward_text	t_server_language_tansuo_normal_text	恭喜您排名第%d名，这是您的奖励
ds_normal_reward_title	t_server_language_ds_normal_reward_title	大师联赛排名奖励
ds_normal_reward_text	t_server_language_ds_normal_reward_text	恭喜您排名第%d名，这是您的奖励
change_name_guildd_title	t_server_language_change_name_guildd_title	军团改名通知
change_name_guildd_title_text1	t_server_language_change_name_guildd_text1	您所在的[ffff00]%s[-]军团已由军团长[ffff00]%s[-]改名为[ffff00]%s[-]，请大家知晓并相互告知！
change_name_guildd_title_text2	t_server_language_change_name_guildd_text2	您所在的[ffff00]%s[-]军团已由副军团长[ffff00]%s[-]改名为[ffff00]%s[-]，请大家知晓并相互告知！
guild_pvp_fight_player_title	t_server_language_guild_pvp_fight_player_title	军团战个人排名奖励
guild_pvp_fight_player_text	t_server_language_guild_pvp_fight_player_text	恭喜您排名第%d名，这是您的奖励
guild_pvp_fight_guild_title	t_server_language_guild_pvp_fight_guild_title	军团战军团排名奖励
guild_pvp_fight_guild_text	t_server_language_guild_pvp_fight_guild_text	恭喜您军团排名第%d名，这是您的奖励
